XXXXXXXXXXX XXXXXXXXX
X     X             X
X X XXX XXXXXXXXX X X
X X   X   X     X X X
X XXX XXX XXX XXX X X
X X X   X   X X   X X
X X XXX XXX X X XXX X
X     X       X X   X
XXXXX XXXXXXXXX X XXX
X   X X     X   X   X
X XXX XXXXX X XXX XXX
X     X     X   X X X
X XXXXXXX X XXX XXX X
X       X X   X   X X
XXXXXXX XXXXX XXX X X
X X   X     X X   X X
X X X XXXXX X X XXX X
X X X   X   X X   X X
X X XXX X XXX XXX X X
X     X         X   X
XXXXXXXXXXXXXXXXXXXXX
