XXXXXXXXXXXXXXXXXXXXXXX XXXXX
X   X     X     X   X X     X
X XXXXX XXXXX XXXXX X X XXXXX
X   X         X     X X     X
X XXX XXXXXXX XXXXX X XXXXX X
X X       X     X X X X   X X
X X X XXXXXXXXX X X X XXX X X
X X X X       X X X X X X   X
X XXXXX X XXXXX X X X X XXX X
X   X   X X X       X       X
X XXXXX XXX X XXX XXX XXXXXXX
X X X           X         X X
X X XXXXX XXXXXXXXXXX XXXXX X
X   X X X       X     X     X
XXX X X XXXXXX XXXX XXX X XXX
X   X                 X X   X
X XXXXXXXXXXX XXXXX X X XXXXX
X   X             X X       X
X XXXXXXXXX XXXXXXXXXXX XXXXX
X           X   X X   X     X
X X XXX XXXXX X X X X XXX XXX
X X X X X     X   X X   X   X
X XXX XXX X XXX X XXX XXX X X
X       X X X X X X   X   X X
X XXX X X X X X X X X X XXXXX
X   X X   X X   X X X   X   X
X XXX XXX X XXX XXXXX XXXXX X
X X     X X X     X         X
XXXXXXXXXXXXXXXXXXXXXXXXXXXXX
